159, 159, 159, 159, 159, 159, 159, 159, 159, 159, 159, 159, 159, 159, 159, 159, 159, 159, 159, 159, 159, 159, 159, 159, 159, 159, 159, 159, 159, 159, 159, 112, 113, 113, 113, 113, 113, 113, 113, 113, 113, 113, 113, 113, 113, 114, 159, 159, 159, 159, 159, 159, 159, 159, 159, 159, 159, 159, 159, 159, 159, 159, 159, 159, 159, 159, 159, 159, 159, 159, 159, 159, 159, 159, 159, 159, 159, 159, 159, 159, 159, 159, 159, 159, 159, 159, 159, 159, 159, 159, 159, 159, 159, 159, 159, 159, 159, 159, 159, 159,
159, 159, 159, 159, 159, 159, 159, 159, 159, 159, 159, 159, 159, 159, 159, 159, 159, 159, 159, 159, 159, 159, 159, 159, 159, 159, 159, 159, 159, 159, 159, 134, 47, 47, 47, 47, 47, 47, 47, 47, 47, 47, 47, 47, 47, 137, 113, 113, 113, 113, 113, 113, 113, 113, 113, 113, 113, 113, 113, 113, 113, 113, 113, 113, 113, 113, 113, 113, 113, 113, 113, 113, 113, 113, 113, 113, 113, 113, 113, 113, 113, 113, 113, 113, 113, 113, 113, 113, 113, 113, 113, 113, 113, 113, 113, 113, 113, 113, 113, 113,
159, 159, 159, 159, 159, 159, 159, 159, 159, 159, 159, 159, 159, 159, 159, 159, 159, 159, 159, 159, 159, 159, 159, 159, 159, 159, 159, 159, 159, 159, 159, 134, 47, 69, 69, 69, 69, 69, 69, 69, 47, 47, 47, 47, 47, 29, 91, 91, 91, 91, 91, 91, 91, 91, 91, 91, 91, 91, 91, 91, 91, 91, 91, 91, 91, 91, 91, 91, 91, 91, 91, 91, 91, 91, 91, 91, 91, 91, 91, 91, 91, 91, 91, 91, 91, 91, 91, 91, 91, 91, 91, 91, 91, 91, 91, 91, 91, 91, 91, 91,
159, 159, 159, 159, 159, 159, 159, 159, 159, 112, 113, 113, 113, 113, 113, 113, 113, 113, 113, 113, 113, 113, 113, 113, 113, 113, 113, 113, 113, 113, 113, 138, 47, 47, 47, 47, 47, 47, 47, 47, 47, 69, 47, 47, 47, 50, 47, 47, 47, 47, 47, 47, 47, 47, 47, 47, 47, 47, 47, 47, 47, 47, 47, 47, 47, 47, 47, 47, 47, 47, 47, 47, 47, 47, 47, 47, 47, 47, 47, 47, 47, 47, 47, 47, 47, 47, 47, 47, 47, 47, 47, 47, 47, 47, 47, 47, 47, 47, 47, 47,
159, 159, 159, 159, 159, 159, 159, 159, 159, 134, 47, 47, 47, 47, 47, 47, 47, 47, 47, 47, 47, 47, 47, 47, 47, 47, 47, 47, 47, 47, 69, 69, 47, 115, 157, 157, 157, 157, 116, 47, 47, 47, 69, 69, 69, 72, 47, 47, 47, 47, 47, 47, 47, 47, 47, 47, 47, 47, 47, 47, 47, 47, 47, 47, 47, 47, 47, 47, 47, 47, 47, 47, 47, 47, 47, 47, 47, 47, 47, 47, 47, 47, 47, 47, 47, 47, 47, 47, 47, 47, 47, 47, 47, 47, 47, 47, 47, 47, 47, 47,
159, 159, 159, 159, 159, 159, 159, 159, 159, 134, 47, 47, 47, 47, 47, 47, 47, 47, 47, 47, 47, 47, 47, 47, 47, 47, 47, 47, 47, 47, 47, 47, 47, 136, 159, 112, 113, 113, 138, 47, 47, 69, 69, 47, 54, 72, 47, 47, 47, 47, 47, 47, 47, 47, 47, 47, 47, 47, 47, 47, 47, 47, 47, 47, 47, 47, 47, 47, 47, 47, 47, 47, 47, 47, 47, 47, 47, 47, 47, 47, 47, 47, 47, 47, 47, 47, 47, 47, 47, 47, 47, 47, 47, 24, 25, 25, 25, 25, 25, 25,
159, 159, 159, 159, 159, 159, 159, 159, 159, 134, 29, 91, 91, 30, 47, 47, 24, 25, 25, 25, 25, 25, 25, 25, 25, 25, 28, 47, 47, 47, 47, 47, 47, 137, 113, 138, 47, 47, 47, 33, 69, 69, 69, 69, 69, 72, 47, 24, 25, 25, 25, 25, 25, 25, 25, 25, 25, 25, 25, 25, 25, 28, 47, 47, 24, 25, 25, 25, 25, 25, 25, 25, 25, 25, 25, 25, 25, 25, 25, 25, 25, 25, 25, 25, 25, 25, 25, 25, 28, 47, 47, 47, 47, 46, 47, 47, 47, 47, 47, 47,
159, 159, 159, 159, 159, 159, 159, 159, 159, 134, 50, 47, 47, 46, 47, 47, 46, 29, 91, 91, 91, 91, 91, 91, 91, 30, 50, 47, 47, 71, 47, 47, 55, 47, 54, 47, 47, 47, 47, 47, 47, 47, 47, 47, 69, 72, 47, 46, 29, 91, 91, 91, 91, 91, 91, 91, 91, 91, 91, 91, 30, 50, 47, 47, 46, 47, 47, 47, 47, 47, 47, 47, 47, 47, 47, 47, 47, 47, 47, 47, 47, 47, 47, 47, 47, 47, 47, 47, 72, 47, 47, 47, 47, 46, 47, 47, 47, 47, 47, 47,
159, 159, 159, 159, 159, 159, 159, 159, 159, 134, 72, 47, 47, 68, 47, 47, 68, 50, 47, 47, 47, 47, 47, 47, 47, 68, 72, 47, 47, 93, 91, 91, 91, 91, 30, 69, 69, 99, 31, 69, 69, 69, 69, 69, 47, 72, 47, 46, 50, 47, 47, 47, 47, 47, 47, 47, 47, 47, 47, 47, 46, 72, 47, 47, 46, 47, 47, 47, 47, 47, 47, 47, 47, 47, 47, 47, 47, 47, 47, 47, 47, 47, 47, 47, 47, 47, 47, 47, 72, 47, 47, 47, 47, 46, 47, 47, 47, 47, 47, 47,
159, 159, 159, 159, 159, 159, 159, 159, 159, 134, 50, 47, 47, 46, 47, 47, 46, 50, 47, 47, 47, 47, 47, 47, 47, 68, 50, 47, 47, 47, 47, 69, 69, 69, 68, 69, 69, 69, 69, 69, 69, 69, 70, 69, 71, 72, 47, 46, 50, 47, 47, 47, 47, 47, 47, 47, 47, 47, 47, 47, 46, 72, 47, 47, 46, 47, 47, 47, 47, 47, 47, 47, 47, 47, 47, 47, 47, 47, 47, 47, 47, 47, 47, 47, 47, 47, 47, 47, 72, 47, 47, 47, 47, 46, 47, 47, 47, 47, 47, 47,
159, 159, 159, 159, 159, 159, 159, 159, 159, 134, 72, 47, 47, 68, 47, 47, 68, 50, 47, 47, 47, 47, 47, 47, 47, 68, 72, 47, 47, 47, 47, 69, 54, 55, 90, 91, 91, 91, 91, 91, 91, 91, 92, 69, 93, 94, 47, 46, 50, 47, 47, 93, 91, 91, 91, 91, 91, 30, 47, 47, 46, 72, 47, 47, 46, 47, 47, 47, 47, 47, 47, 47, 47, 47, 47, 47, 47, 47, 47, 47, 47, 47, 47, 47, 47, 47, 47, 47, 72, 47, 47, 47, 47, 46, 47, 47, 47, 47, 47, 47,
159, 159, 159, 159, 159, 159, 159, 159, 159, 134, 50, 47, 47, 46, 47, 47, 46, 50, 47, 47, 47, 47, 47, 47, 47, 68, 50, 47, 47, 47, 47, 47, 47, 47, 47, 47, 47, 47, 47, 47, 47, 47, 69, 32, 33, 47, 47, 46, 50, 47, 47, 47, 47, 47, 47, 47, 47, 46, 47, 47, 46, 72, 47, 47, 46, 47, 47, 47, 47, 47, 47, 47, 47, 47, 47, 47, 47, 47, 47, 47, 47, 47, 47, 47, 47, 47, 47, 47, 72, 47, 47, 47, 47, 46, 47, 47, 47, 47, 47, 47,
159, 159, 159, 159, 159, 159, 159, 159, 159, 134, 72, 47, 47, 68, 47, 47, 68, 50, 47, 47, 47, 47, 47, 47, 47, 68, 72, 47, 47, 47, 47, 47, 47, 47, 47, 47, 47, 47, 47, 47, 47, 47, 47, 47, 47, 47, 47, 46, 50, 47, 47, 47, 47, 47, 47, 47, 47, 46, 47, 47, 46, 72, 47, 47, 46, 47, 47, 47, 47, 47, 47, 47, 47, 47, 47, 47, 47, 47, 47, 47, 47, 47, 47, 47, 47, 47, 47, 47, 72, 47, 47, 47, 47, 46, 47, 47, 47, 47, 47, 47,
159, 159, 159, 159, 159, 159, 159, 159, 159, 134, 50, 47, 47, 46, 47, 47, 90, 94, 47, 47, 47, 47, 47, 47, 47, 68, 50, 47, 47, 47, 47, 47, 47, 47, 47, 47, 47, 47, 47, 47, 47, 47, 47, 47, 47, 47, 47, 46, 50, 47, 47, 47, 24, 25, 25, 25, 25, 52, 47, 47, 46, 72, 47, 47, 46, 47, 47, 47, 47, 47, 47, 47, 47, 47, 47, 47, 47, 47, 47, 47, 47, 47, 47, 47, 47, 47, 47, 47, 72, 47, 47, 47, 47, 46, 47, 47, 47, 47, 47, 47,
159, 159, 159, 159, 159, 159, 159, 159, 159, 134, 72, 47, 47, 90, 91, 91, 92, 47, 47, 47, 47, 47, 47, 47, 47, 68, 72, 47, 47, 47, 47, 47, 47, 47, 47, 47, 47, 47, 47, 47, 47, 47, 47, 47, 47, 47, 47, 46, 50, 47, 47, 47, 47, 47, 47, 47, 47, 47, 47, 47, 46, 72, 47, 47, 46, 47, 47, 47, 47, 47, 47, 47, 47, 47, 47, 47, 47, 47, 47, 47, 47, 47, 47, 47, 47, 47, 47, 47, 72, 47, 47, 47, 47, 46, 47, 47, 47, 47, 47, 47,
113, 113, 113, 113, 113, 113, 113, 113, 113, 138, 51, 28, 47, 47, 47, 47, 47, 47, 47, 47, 47, 47, 47, 47, 47, 68, 50, 47, 47, 47, 47, 47, 47, 47, 47, 47, 47, 47, 47, 47, 47, 47, 47, 47, 47, 47, 47, 46, 50, 47, 47, 47, 47, 47, 47, 47, 47, 47, 47, 47, 46, 72, 47, 47, 46, 47, 47, 47, 47, 47, 47, 47, 47, 47, 47, 47, 47, 47, 47, 47, 47, 47, 47, 47, 47, 47, 47, 47, 72, 47, 47, 47, 47, 46, 47, 47, 47, 47, 47, 47,
91, 91, 91, 91, 91, 91, 91, 91, 91, 91, 30, 50, 47, 24, 25, 25, 25, 25, 25, 25, 25, 25, 25, 25, 25, 52, 72, 47, 47, 47, 47, 47, 47, 47, 47, 47, 47, 47, 47, 47, 47, 47, 47, 47, 47, 47, 47, 46, 50, 47, 47, 47, 27, 25, 25, 25, 25, 25, 25, 25, 52, 72, 47, 47, 46, 47, 47, 47, 47, 47, 47, 47, 47, 47, 47, 47, 47, 47, 47, 47, 47, 47, 47, 47, 47, 47, 47, 47, 72, 47, 47, 47, 47, 46, 47, 47, 47, 47, 47, 47,
47, 47, 47, 47, 47, 47, 47, 47, 47, 47, 46, 72, 47, 46, 47, 47, 47, 47, 47, 47, 47, 47, 47, 47, 47, 47, 50, 47, 47, 47, 47, 47, 47, 47, 47, 47, 47, 47, 47, 47, 47, 47, 47, 47, 47, 47, 47, 46, 50, 47, 93, 91, 91, 91, 91, 91, 91, 91, 91, 91, 91, 94, 47, 47, 46, 47, 47, 47, 47, 47, 47, 47, 47, 47, 47, 47, 47, 47, 47, 47, 47, 47, 47, 47, 47, 47, 47, 47, 72, 47, 47, 47, 47, 46, 47, 47, 47, 47, 47, 47,
47, 47, 47, 47, 47, 47, 47, 47, 47, 47, 68, 50, 47, 46, 47, 47, 47, 47, 47, 47, 47, 47, 47, 47, 47, 47, 72, 47, 47, 47, 47, 47, 47, 47, 47, 47, 47, 47, 47, 47, 47, 47, 47, 47, 47, 47, 47, 46, 50, 47, 47, 47, 47, 47, 47, 47, 47, 47, 47, 47, 47, 47, 47, 47, 46, 47, 47, 47, 47, 47, 47, 47, 47, 47, 47, 47, 47, 47, 47, 47, 47, 47, 47, 47, 47, 47, 47, 47, 72, 47, 47, 47, 47, 46, 47, 47, 47, 47, 47, 47,
47, 47, 47, 47, 47, 47, 47, 47, 47, 47, 46, 72, 47, 46, 47, 47, 47, 47, 47, 47, 47, 47, 47, 47, 47, 47, 50, 47, 47, 47, 47, 47, 47, 47, 47, 47, 47, 47, 47, 47, 47, 47, 47, 47, 47, 47, 47, 46, 51, 25, 25, 25, 25, 25, 25, 25, 25, 25, 25, 25, 25, 28, 47, 47, 46, 47, 47, 47, 47, 47, 47, 47, 47, 47, 47, 47, 47, 47, 47, 47, 47, 47, 47, 47, 47, 47, 47, 47, 72, 47, 47, 47, 47, 46, 47, 47, 47, 47, 47, 47,
47, 47, 47, 47, 47, 47, 47, 47, 47, 47, 68, 50, 47, 90, 91, 91, 91, 91, 91, 91, 91, 91, 91, 91, 91, 91, 94, 47, 47, 47, 47, 47, 47, 47, 47, 47, 47, 47, 47, 47, 47, 47, 47, 47, 47, 47, 47, 90, 91, 91, 91, 91, 91, 91, 91, 91, 91, 91, 91, 91, 30, 50, 47, 47, 46, 47, 47, 47, 47, 47, 47, 47, 47, 47, 47, 47, 47, 47, 47, 47, 47, 47, 47, 47, 47, 47, 47, 47, 72, 47, 47, 47, 47, 46, 47, 47, 47, 47, 47, 47,
47, 47, 47, 47, 47, 47, 47, 47, 47, 47, 46, 72, 47, 47, 47, 47, 47, 47, 47, 47, 47, 47, 47, 47, 47, 47, 47, 47, 47, 47, 47, 47, 47, 47, 47, 47, 47, 47, 47, 47, 47, 47, 47, 47, 47, 47, 47, 47, 47, 47, 47, 47, 47, 47, 47, 47, 47, 47, 47, 47, 46, 50, 47, 47, 46, 47, 47, 47, 47, 47, 47, 47, 47, 47, 47, 47, 47, 47, 47, 47, 47, 47, 47, 47, 47, 47, 47, 47, 72, 47, 47, 47, 47, 46, 47, 47, 47, 47, 47, 47,
47, 47, 47, 47, 47, 47, 47, 47, 47, 47, 68, 50, 47, 47, 47, 47, 47, 47, 47, 47, 47, 47, 47, 47, 47, 47, 47, 47, 47, 47, 47, 47, 47, 47, 47, 47, 47, 47, 47, 47, 47, 47, 47, 47, 47, 47, 47, 47, 47, 47, 47, 47, 47, 47, 47, 47, 47, 47, 47, 47, 46, 50, 47, 47, 46, 47, 47, 47, 47, 47, 47, 47, 47, 47, 47, 47, 47, 47, 47, 47, 47, 47, 47, 47, 47, 47, 47, 47, 72, 47, 47, 47, 47, 46, 47, 47, 47, 47, 47, 47,
47, 47, 47, 47, 47, 47, 47, 47, 47, 47, 90, 94, 47, 47, 47, 47, 47, 47, 47, 47, 47, 47, 47, 47, 47, 47, 47, 47, 47, 47, 47, 47, 47, 47, 47, 47, 47, 47, 47, 47, 47, 47, 47, 47, 47, 47, 47, 47, 47, 47, 47, 47, 47, 47, 47, 47, 47, 47, 47, 47, 90, 94, 47, 47, 90, 91, 91, 91, 91, 91, 91, 91, 91, 91, 91, 91, 91, 91, 91, 91, 91, 91, 91, 92, 47, 47, 93, 91, 94, 47, 47, 47, 47, 46, 47, 47, 47, 47, 47, 47,
25, 25, 25, 25, 25, 25, 25, 25, 25, 25, 25, 25, 25, 25, 25, 25, 25, 25, 25, 25, 25, 25, 25, 25, 25, 25, 25, 25, 28, 47, 47, 47, 47, 47, 47, 47, 47, 47, 47, 47, 47, 47, 47, 47, 47, 47, 47, 47, 47, 47, 47, 47, 47, 47, 47, 47, 47, 47, 47, 47, 47, 47, 47, 47, 47, 47, 47, 47, 47, 47, 47, 47, 47, 47, 47, 47, 47, 47, 47, 47, 47, 47, 47, 47, 47, 47, 47, 47, 47, 47, 47, 47, 47, 46, 47, 47, 47, 47, 47, 47,
47, 47, 47, 47, 47, 47, 47, 47, 47, 47, 47, 47, 47, 47, 47, 47, 47, 47, 47, 47, 47, 47, 47, 47, 47, 47, 47, 47, 50, 47, 47, 24, 25, 25, 26, 47, 47, 47, 27, 25, 28, 47, 47, 24, 25, 25, 25, 25, 25, 25, 25, 25, 25, 25, 25, 25, 25, 25, 25, 25, 25, 28, 47, 47, 47, 47, 47, 47, 47, 47, 47, 47, 47, 47, 47, 47, 47, 47, 47, 47, 47, 47, 47, 47, 47, 47, 47, 47, 47, 47, 47, 47, 47, 46, 47, 47, 47, 47, 47, 47,
47, 47, 47, 47, 47, 47, 47, 47, 47, 47, 47, 47, 47, 47, 47, 47, 47, 47, 47, 47, 47, 47, 47, 47, 47, 47, 47, 47, 50, 47, 47, 46, 47, 47, 47, 47, 47, 47, 47, 47, 50, 47, 47, 68, 47, 47, 47, 47, 47, 47, 47, 47, 47, 47, 47, 47, 47, 47, 47, 47, 47, 50, 47, 47, 47, 47, 47, 47, 47, 47, 47, 47, 47, 47, 47, 47, 47, 47, 47, 47, 47, 47, 47, 47, 47, 47, 47, 47, 47, 47, 47, 47, 47, 46, 47, 47, 47, 47, 47, 47,
47, 47, 47, 47, 47, 47, 47, 47, 47, 47, 47, 47, 47, 47, 47, 47, 47, 47, 47, 47, 47, 47, 47, 47, 47, 47, 47, 47, 50, 47, 47, 46, 47, 47, 47, 47, 47, 47, 47, 47, 50, 47, 47, 90, 91, 91, 91, 91, 91, 91, 91, 91, 91, 91, 91, 91, 91, 91, 91, 91, 91, 94, 47, 47, 47, 47, 47, 47, 47, 47, 47, 47, 47, 47, 47, 47, 47, 47, 47, 47, 47, 47, 47, 47, 47, 47, 47, 47, 47, 47, 47, 47, 47, 46, 47, 47, 47, 47, 47, 47,
47, 47, 47, 47, 47, 47, 47, 47, 47, 47, 47, 47, 47, 47, 47, 47, 47, 47, 47, 47, 47, 47, 47, 47, 47, 47, 47, 47, 50, 47, 47, 46, 47, 47, 47, 47, 47, 47, 47, 47, 50, 47, 47, 47, 47, 47, 47, 47, 47, 47, 47, 47, 47, 47, 47, 47, 47, 47, 47, 47, 69, 69, 47, 47, 47, 47, 47, 47, 47, 47, 47, 47, 47, 47, 47, 47, 47, 47, 47, 47, 47, 47, 47, 47, 47, 47, 47, 47, 47, 47, 47, 47, 47, 46, 47, 47, 47, 47, 47, 47,
47, 47, 47, 47, 47, 47, 47, 47, 47, 47, 47, 47, 47, 47, 47, 47, 47, 47, 47, 47, 47, 47, 47, 47, 47, 47, 47, 47, 50, 47, 47, 46, 47, 47, 47, 47, 47, 47, 47, 47, 50, 47, 47, 47, 47, 47, 47, 47, 47, 47, 47, 47, 47, 47, 47, 47, 47, 47, 47, 47, 24, 28, 47, 47, 24, 25, 25, 25, 25, 25, 25, 25, 25, 25, 25, 25, 25, 25, 28, 47, 47, 47, 47, 47, 47, 47, 47, 47, 47, 47, 47, 47, 47, 46, 47, 47, 47, 47, 47, 47,
47, 47, 47, 47, 47, 47, 47, 47, 47, 47, 47, 47, 47, 47, 47, 47, 47, 47, 47, 47, 47, 47, 47, 47, 47, 47, 47, 47, 50, 47, 47, 46, 47, 47, 47, 47, 47, 47, 47, 47, 50, 47, 47, 47, 47, 47, 47, 47, 47, 47, 47, 47, 47, 47, 47, 47, 47, 47, 47, 47, 46, 50, 47, 47, 46, 47, 47, 47, 47, 47, 47, 47, 47, 47, 47, 47, 47, 47, 50, 47, 47, 47, 47, 47, 47, 47, 47, 47, 47, 47, 47, 47, 47, 46, 47, 47, 47, 47, 47, 47,
47, 47, 47, 47, 47, 47, 47, 47, 47, 47, 47, 47, 47, 47, 47, 47, 47, 47, 47, 47, 47, 47, 47, 47, 47, 47, 47, 47, 50, 47, 47, 46, 47, 47, 47, 47, 47, 47, 47, 47, 50, 47, 47, 47, 47, 47, 47, 47, 47, 47, 47, 47, 47, 47, 47, 47, 47, 47, 47, 47, 46, 50, 47, 47, 46, 47, 47, 47, 47, 47, 47, 47, 47, 47, 47, 47, 47, 47, 50, 47, 47, 47, 47, 47, 47, 47, 47, 47, 47, 47, 47, 47, 47, 46, 47, 47, 47, 47, 47, 47,
47, 47, 47, 47, 47, 47, 47, 47, 47, 47, 47, 47, 47, 47, 47, 47, 47, 47, 47, 47, 47, 47, 47, 47, 47, 47, 47, 47, 50, 47, 47, 46, 47, 47, 47, 47, 47, 47, 47, 47, 50, 47, 47, 47, 47, 47, 47, 47, 47, 47, 47, 47, 47, 47, 47, 47, 47, 47, 47, 47, 46, 50, 47, 47, 46, 47, 47, 47, 47, 47, 47, 47, 47, 47, 47, 47, 47, 47, 72, 47, 47, 47, 47, 47, 47, 47, 47, 47, 47, 47, 47, 47, 47, 46, 47, 47, 47, 47, 47, 47,
47, 47, 47, 47, 47, 47, 47, 47, 47, 47, 47, 47, 47, 47, 47, 47, 47, 47, 47, 47, 47, 47, 47, 47, 47, 47, 47, 47, 50, 47, 47, 46, 47, 47, 47, 47, 47, 47, 47, 47, 50, 47, 47, 47, 47, 47, 47, 47, 47, 47, 47, 47, 47, 47, 47, 47, 47, 47, 47, 47, 46, 50, 47, 47, 90, 91, 91, 91, 91, 91, 91, 91, 91, 91, 91, 91, 91, 91, 94, 47, 47, 47, 47, 47, 47, 47, 47, 47, 47, 47, 47, 47, 47, 46, 47, 47, 47, 47, 47, 47,
47, 47, 47, 47, 47, 47, 47, 47, 47, 47, 47, 47, 47, 47, 47, 47, 47, 47, 47, 47, 47, 47, 47, 47, 47, 47, 47, 47, 50, 47, 47, 46, 47, 47, 47, 47, 47, 47, 47, 47, 50, 47, 47, 47, 47, 47, 47, 47, 47, 47, 47, 47, 47, 47, 47, 47, 47, 47, 47, 47, 46, 50, 47, 47, 47, 47, 47, 47, 47, 47, 47, 47, 47, 47, 47, 47, 47, 47, 47, 47, 47, 47, 47, 47, 47, 47, 47, 47, 47, 47, 47, 47, 47, 46, 47, 47, 47, 47, 47, 47,
47, 47, 47, 47, 47, 47, 47, 47, 47, 47, 47, 47, 47, 47, 47, 47, 47, 47, 47, 47, 47, 47, 47, 47, 47, 47, 47, 47, 50, 47, 47, 46, 47, 47, 47, 47, 47, 47, 47, 47, 50, 47, 47, 47, 47, 47, 47, 47, 47, 47, 47, 47, 47, 47, 47, 47, 47, 47, 47, 47, 46, 50, 47, 47, 47, 47, 47, 47, 47, 47, 47, 47, 47, 47, 47, 47, 47, 47, 47, 47, 47, 47, 47, 47, 47, 47, 47, 47, 47, 47, 47, 47, 47, 46, 47, 47, 47, 47, 47, 47,
47, 47, 47, 47, 47, 47, 47, 47, 47, 47, 47, 47, 47, 47, 47, 47, 47, 47, 47, 47, 47, 47, 47, 47, 47, 47, 47, 47, 50, 47, 47, 46, 47, 47, 47, 47, 47, 47, 47, 47, 50, 47, 47, 47, 47, 47, 47, 47, 47, 47, 47, 47, 47, 47, 47, 47, 47, 47, 47, 47, 46, 51, 25, 25, 25, 25, 25, 25, 25, 25, 25, 25, 25, 28, 47, 47, 47, 47, 47, 47, 47, 47, 47, 47, 47, 47, 47, 47, 47, 47, 47, 47, 47, 90, 91, 91, 91, 91, 91, 91,
47, 47, 47, 47, 47, 29, 91, 91, 91, 91, 91, 91, 91, 91, 91, 91, 91, 91, 91, 91, 91, 91, 91, 91, 91, 91, 91, 91, 94, 47, 47, 46, 47, 47, 47, 47, 47, 47, 47, 47, 50, 47, 47, 47, 47, 47, 47, 47, 47, 47, 47, 47, 47, 47, 47, 47, 47, 47, 47, 47, 68, 47, 47, 47, 47, 47, 47, 47, 47, 47, 47, 47, 47, 72, 47, 47, 47, 47, 47, 47, 47, 47, 47, 47, 47, 47, 47, 47, 47, 47, 47, 47, 47, 47, 47, 47, 47, 47, 47, 47,
47, 47, 47, 47, 47, 50, 47, 47, 47, 47, 47, 47, 47, 47, 47, 47, 47, 47, 47, 47, 47, 47, 47, 47, 47, 47, 47, 47, 47, 47, 47, 46, 47, 47, 47, 47, 47, 47, 47, 47, 50, 47, 47, 47, 47, 47, 47, 47, 47, 47, 47, 47, 47, 47, 47, 47, 47, 47, 47, 47, 90, 91, 91, 91, 91, 91, 91, 91, 91, 91, 91, 91, 91, 94, 47, 47, 47, 47, 47, 47, 47, 47, 47, 47, 47, 47, 47, 47, 47, 47, 47, 47, 47, 47, 47, 47, 47, 47, 47, 47,
47, 47, 47, 47, 47, 72, 47, 47, 47, 47, 47, 47, 47, 47, 47, 47, 47, 47, 47, 47, 47, 47, 47, 47, 47, 47, 47, 47, 47, 47, 47, 46, 47, 47, 47, 47, 47, 47, 47, 47, 50, 47, 47, 47, 47, 47, 47, 47, 47, 47, 47, 47, 47, 47, 47, 47, 47, 47, 47, 47, 47, 47, 47, 47, 47, 47, 47, 47, 47, 47, 47, 47, 47, 47, 47, 47, 47, 47, 47, 47, 47, 47, 47, 47, 47, 47, 47, 47, 47, 47, 47, 47, 47, 47, 47, 47, 47, 47, 47, 47,
47, 47, 47, 47, 47, 50, 47, 47, 47, 47, 47, 47, 47, 47, 47, 47, 47, 47, 47, 47, 47, 47, 47, 47, 47, 47, 47, 47, 47, 47, 47, 46, 47, 47, 47, 47, 47, 47, 47, 47, 50, 47, 47, 24, 25, 25, 25, 25, 25, 25, 25, 25, 25, 25, 25, 25, 25, 25, 25, 25, 25, 25, 25, 25, 25, 25, 25, 25, 25, 25, 25, 25, 25, 25, 25, 25, 25, 25, 25, 25, 25, 25, 25, 25, 25, 25, 25, 25, 25, 25, 25, 25, 25, 25, 25, 25, 25, 25, 25, 25,
47, 47, 47, 47, 47, 72, 47, 47, 47, 47, 47, 47, 47, 47, 47, 47, 47, 47, 47, 47, 47, 47, 47, 47, 47, 47, 47, 47, 47, 47, 47, 46, 47, 47, 47, 47, 47, 47, 47, 47, 50, 47, 47, 46, 47, 47, 47, 47, 47, 47, 47, 47, 47, 47, 47, 47, 47, 47, 47, 47, 47, 47, 47, 47, 47, 47, 47, 47, 47, 47, 47, 47, 47, 47, 47, 47, 47, 47, 47, 47, 47, 47, 47, 47, 47, 47, 47, 47, 47, 47, 47, 47, 47, 47, 47, 47, 47, 47, 47, 47,
47, 47, 47, 47, 47, 51, 25, 25, 25, 25, 25, 25, 25, 25, 25, 25, 25, 25, 25, 25, 25, 25, 25, 25, 25, 25, 25, 25, 25, 25, 25, 52, 47, 47, 47, 47, 47, 47, 47, 47, 50, 47, 47, 46, 47, 47, 47, 47, 47, 47, 47, 47, 47, 47, 47, 47, 47, 47, 47, 47, 47, 47, 47, 47, 47, 47, 47, 47, 47, 47, 47, 47, 47, 47, 47, 47, 47, 47, 47, 47, 47, 47, 47, 47, 47, 47, 47, 47, 47, 47, 47, 47, 47, 47, 47, 47, 47, 47, 47, 47,
47, 47, 47, 47, 47, 47, 47, 47, 47, 47, 47, 47, 47, 47, 47, 47, 47, 47, 47, 47, 47, 47, 47, 47, 47, 47, 47, 47, 47, 47, 47, 47, 47, 47, 47, 47, 47, 47, 47, 47, 50, 47, 47, 46, 47, 47, 47, 47, 47, 47, 47, 47, 47, 47, 47, 47, 47, 47, 47, 47, 47, 47, 47, 47, 47, 47, 47, 47, 47, 47, 47, 47, 47, 47, 47, 47, 47, 47, 47, 47, 47, 47, 47, 47, 47, 47, 47, 47, 47, 47, 47, 47, 47, 47, 47, 47, 47, 47, 47, 47,
47, 47, 47, 47, 47, 47, 47, 47, 47, 47, 47, 47, 47, 47, 47, 47, 47, 47, 47, 47, 47, 47, 47, 47, 47, 47, 47, 47, 47, 47, 47, 47, 47, 47, 47, 47, 47, 47, 47, 47, 50, 47, 47, 46, 47, 47, 47, 47, 47, 47, 47, 47, 47, 47, 47, 47, 47, 47, 47, 47, 47, 47, 47, 47, 47, 47, 47, 47, 47, 47, 47, 47, 47, 47, 47, 47, 47, 47, 47, 47, 47, 47, 47, 47, 47, 47, 47, 47, 47, 47, 47, 47, 47, 47, 47, 47, 47, 47, 47, 47,
47, 47, 47, 47, 47, 47, 47, 47, 47, 47, 47, 47, 47, 47, 47, 47, 47, 47, 47, 47, 47, 47, 47, 47, 47, 47, 47, 47, 47, 47, 47, 47, 47, 47, 47, 47, 47, 47, 47, 47, 50, 47, 47, 46, 47, 47, 47, 47, 47, 47, 47, 47, 47, 47, 47, 47, 47, 47, 47, 47, 47, 47, 47, 47, 47, 47, 47, 47, 47, 47, 47, 47, 47, 47, 47, 47, 47, 47, 47, 47, 47, 47, 47, 47, 47, 47, 47, 47, 47, 47, 47, 47, 47, 47, 47, 47, 47, 47, 47, 47,
47, 47, 47, 47, 47, 47, 47, 47, 47, 47, 47, 47, 47, 47, 47, 47, 47, 47, 47, 47, 47, 47, 47, 47, 47, 47, 47, 47, 47, 47, 47, 47, 47, 47, 47, 47, 47, 47, 47, 47, 50, 47, 47, 46, 47, 47, 47, 47, 47, 47, 47, 47, 47, 47, 47, 47, 47, 47, 47, 47, 47, 47, 47, 47, 47, 47, 47, 47, 47, 47, 47, 47, 47, 47, 47, 47, 47, 47, 47, 47, 47, 47, 47, 47, 47, 47, 47, 47, 47, 47, 47, 47, 47, 47, 47, 47, 47, 47, 47, 47,
47, 47, 47, 47, 47, 47, 47, 47, 47, 47, 47, 47, 47, 47, 47, 47, 47, 47, 47, 47, 47, 47, 47, 47, 47, 47, 47, 47, 47, 47, 47, 47, 47, 47, 47, 47, 47, 47, 47, 47, 50, 47, 47, 46, 47, 47, 47, 47, 47, 47, 47, 47, 47, 47, 47, 47, 47, 47, 47, 47, 47, 47, 47, 47, 47, 47, 47, 47, 47, 47, 47, 47, 47, 47, 47, 47, 47, 47, 47, 47, 47, 47, 47, 47, 47, 47, 47, 47, 47, 47, 47, 47, 47, 47, 47, 47, 47, 47, 47, 47,
47, 47, 47, 47, 47, 47, 47, 47, 47, 47, 47, 47, 47, 47, 47, 47, 47, 47, 47, 47, 47, 47, 47, 47, 47, 47, 47, 47, 47, 47, 47, 47, 47, 47, 47, 47, 47, 47, 47, 47, 50, 47, 47, 46, 47, 47, 47, 47, 47, 47, 47, 47, 47, 47, 47, 47, 47, 47, 47, 47, 47, 47, 47, 47, 47, 47, 47, 47, 47, 47, 47, 47, 47, 47, 47, 47, 47, 47, 47, 47, 47, 47, 47, 47, 47, 47, 47, 47, 47, 47, 47, 47, 47, 47, 47, 47, 47, 47, 47, 47,
47, 47, 47, 47, 47, 47, 47, 47, 47, 47, 47, 47, 47, 47, 47, 47, 47, 47, 47, 47, 47, 47, 47, 47, 47, 47, 47, 47, 47, 47, 47, 47, 47, 47, 47, 47, 47, 47, 47, 47, 50, 47, 47, 46, 47, 47, 47, 47, 47, 47, 47, 47, 47, 47, 47, 47, 47, 47, 47, 47, 47, 47, 47, 47, 47, 47, 47, 47, 47, 47, 47, 47, 47, 47, 47, 47, 47, 47, 47, 47, 47, 47, 47, 47, 47, 47, 47, 47, 47, 47, 47, 47, 47, 47, 47, 47, 47, 47, 47, 47,