266, 266, 266, 266, 266, 266, 266, 266, 266, 266, 266, 266, 266, 266, 266, 266, 266, 266, 266, 266, 266, 266, 266, 266, 266, 266, 266, 266, 266, 266, 266, 266, 266, 266, 266, 266, 266, 266, 266, 266, 266, 266, 266, 266, 266, 266, 266, 266, 266, 266, 266, 266, 266, 266, 266, 266, 266, 266, 266, 266, 266, 266, 266, 266, 266, 266, 266, 266, 266, 266, 266, 266, 266, 266, 266, 266, 266, 266, 266, 266, 266, 266, 266, 266, 266, 266, 266, 266, 266, 266, 266, 266, 266, 266, 266, 266, 266, 266, 266, 266,
266, 266, 266, 266, 266, 266, 266, 266, 266, 266, 266, 266, 266, 266, 266, 266, 266, 266, 266, 266, 266, 266, 266, 266, 266, 266, 266, 266, 266, 266, 266, 266, 265, 265, 265, 265, 265, 265, 265, 265, 265, 265, 265, 265, 265, 266, 266, 266, 266, 266, 266, 266, 266, 266, 266, 266, 266, 266, 266, 266, 266, 266, 266, 266, 266, 266, 266, 266, 266, 266, 266, 266, 266, 266, 266, 266, 266, 266, 266, 266, 266, 266, 266, 266, 266, 266, 266, 266, 266, 266, 266, 266, 266, 266, 266, 266, 266, 266, 266, 266,
266, 266, 266, 266, 266, 266, 266, 266, 266, 266, 266, 266, 266, 266, 266, 266, 266, 266, 266, 266, 266, 266, 266, 266, 266, 266, 266, 266, 266, 266, 266, 266, 265, 265, 265, 265, 265, 265, 265, 265, 265, 265, 265, 265, 265, 266, 266, 266, 266, 266, 266, 266, 266, 266, 266, 266, 266, 266, 266, 266, 266, 266, 266, 266, 266, 266, 266, 266, 266, 266, 266, 266, 266, 266, 266, 266, 266, 266, 266, 266, 266, 266, 266, 266, 266, 266, 266, 266, 266, 266, 266, 266, 266, 266, 266, 266, 266, 266, 266, 266,
266, 266, 266, 266, 266, 266, 266, 266, 266, 266, 266, 266, 266, 266, 266, 266, 266, 266, 266, 266, 266, 266, 266, 266, 266, 266, 266, 266, 266, 266, 266, 266, 265, 265, 265, 265, 265, 265, 265, 265, 265, 265, 265, 265, 265, 266, 265, 265, 265, 265, 265, 265, 265, 265, 265, 265, 265, 265, 265, 265, 265, 265, 265, 265, 265, 265, 265, 265, 265, 265, 265, 265, 265, 265, 265, 265, 265, 265, 265, 265, 265, 265, 265, 265, 265, 265, 265, 265, 265, 265, 265, 265, 265, 265, 265, 265, 265, 265, 265, 265,
266, 266, 266, 266, 266, 266, 266, 266, 266, 266, 265, 265, 265, 265, 265, 265, 265, 265, 265, 265, 265, 265, 265, 265, 265, 265, 265, 265, 265, 265, 265, 265, 265, 265, 265, 265, 265, 265, 265, 265, 265, 265, 265, 265, 265, 266, 265, 265, 265, 265, 265, 265, 265, 265, 265, 265, 265, 265, 265, 265, 265, 265, 265, 265, 265, 265, 265, 265, 265, 265, 265, 265, 265, 265, 265, 265, 265, 265, 265, 265, 265, 265, 265, 265, 265, 265, 265, 265, 265, 265, 265, 265, 265, 265, 265, 265, 265, 265, 265, 265,
266, 266, 266, 266, 266, 266, 266, 266, 266, 266, 265, 265, 265, 265, 265, 265, 265, 265, 265, 265, 265, 265, 265, 265, 265, 265, 265, 265, 265, 265, 265, 265, 265, 265, 265, 265, 265, 265, 265, 265, 265, 265, 265, 265, 265, 266, 265, 265, 265, 265, 265, 265, 265, 265, 265, 265, 265, 265, 265, 265, 265, 265, 265, 265, 265, 265, 265, 265, 265, 265, 265, 265, 265, 265, 265, 265, 265, 265, 265, 265, 265, 265, 265, 265, 265, 265, 265, 265, 265, 265, 265, 265, 265, 266, 266, 266, 266, 266, 266, 266,
266, 266, 266, 266, 266, 266, 266, 266, 266, 266, 266, 266, 266, 266, 265, 265, 266, 266, 266, 266, 266, 266, 266, 266, 266, 266, 266, 265, 265, 265, 265, 265, 265, 265, 265, 265, 265, 265, 265, 265, 265, 265, 265, 265, 265, 266, 265, 266, 266, 266, 266, 266, 266, 266, 266, 266, 266, 266, 266, 266, 266, 266, 265, 265, 266, 266, 266, 266, 266, 266, 266, 266, 266, 266, 266, 266, 266, 266, 266, 266, 266, 266, 266, 266, 266, 266, 266, 266, 266, 265, 265, 265, 265, 266, 266, 266, 266, 266, 266, 266,
266, 266, 266, 266, 266, 266, 266, 266, 266, 266, 266, 265, 265, 266, 265, 265, 266, 266, 266, 266, 266, 266, 266, 266, 266, 266, 266, 265, 265, 265, 265, 265, 265, 265, 265, 265, 265, 265, 265, 265, 265, 265, 265, 265, 265, 266, 265, 266, 266, 266, 266, 266, 266, 266, 266, 266, 266, 266, 266, 266, 266, 266, 265, 265, 266, 265, 265, 265, 265, 265, 265, 265, 265, 265, 265, 265, 265, 265, 265, 265, 265, 265, 265, 265, 265, 265, 265, 265, 266, 265, 265, 265, 265, 266, 266, 266, 266, 266, 266, 266,
266, 266, 266, 266, 266, 266, 266, 266, 266, 266, 266, 265, 265, 266, 265, 265, 266, 266, 265, 265, 265, 265, 265, 265, 265, 266, 266, 265, 265, 266, 266, 266, 266, 266, 266, 265, 265, 265, 265, 265, 265, 265, 265, 265, 265, 266, 265, 266, 266, 265, 265, 265, 265, 265, 265, 265, 265, 265, 265, 265, 266, 266, 265, 265, 266, 265, 265, 265, 265, 265, 265, 265, 265, 265, 265, 265, 265, 265, 265, 265, 265, 265, 265, 265, 265, 265, 265, 265, 266, 265, 265, 265, 265, 266, 266, 266, 266, 266, 266, 266,
266, 266, 266, 266, 266, 266, 266, 266, 266, 266, 266, 265, 265, 266, 265, 265, 266, 266, 265, 265, 265, 265, 265, 265, 265, 266, 266, 265, 265, 265, 265, 265, 265, 265, 266, 265, 265, 265, 265, 265, 265, 265, 265, 265, 265, 266, 265, 266, 266, 265, 265, 265, 265, 265, 265, 265, 265, 265, 265, 265, 266, 266, 265, 265, 266, 265, 265, 265, 265, 265, 265, 265, 265, 265, 265, 265, 265, 265, 265, 265, 265, 265, 265, 265, 265, 265, 265, 265, 266, 265, 265, 265, 265, 266, 266, 266, 266, 266, 266, 266,
266, 266, 266, 266, 266, 266, 266, 266, 266, 266, 266, 265, 265, 266, 265, 265, 266, 266, 265, 265, 265, 265, 265, 265, 265, 266, 266, 265, 265, 265, 265, 265, 265, 265, 266, 266, 266, 266, 266, 266, 266, 266, 266, 265, 266, 266, 265, 266, 266, 265, 265, 265, 265, 265, 265, 265, 265, 265, 265, 265, 266, 266, 265, 265, 266, 265, 265, 265, 265, 265, 265, 265, 265, 265, 265, 265, 265, 265, 265, 265, 265, 265, 265, 265, 265, 265, 265, 265, 266, 265, 265, 265, 265, 266, 266, 266, 266, 266, 266, 266,
266, 266, 266, 266, 266, 266, 266, 266, 266, 266, 266, 265, 265, 266, 265, 265, 266, 266, 265, 265, 265, 265, 265, 265, 265, 266, 266, 265, 265, 265, 265, 265, 265, 265, 265, 265, 265, 265, 265, 265, 265, 265, 265, 265, 265, 265, 265, 266, 266, 265, 265, 265, 265, 265, 265, 265, 265, 265, 265, 265, 266, 266, 265, 265, 266, 265, 265, 265, 265, 265, 265, 265, 265, 265, 265, 265, 265, 265, 265, 265, 265, 265, 265, 265, 265, 265, 265, 265, 266, 265, 265, 265, 265, 266, 266, 266, 266, 266, 266, 266,
266, 266, 266, 266, 266, 266, 266, 266, 266, 266, 266, 265, 265, 266, 265, 265, 266, 266, 265, 265, 265, 265, 265, 265, 265, 266, 266, 265, 265, 265, 265, 265, 265, 265, 265, 265, 265, 265, 265, 265, 265, 265, 265, 265, 265, 265, 265, 266, 266, 265, 265, 265, 265, 265, 265, 265, 265, 265, 265, 265, 266, 266, 265, 265, 266, 265, 265, 265, 265, 265, 265, 265, 265, 265, 265, 265, 265, 265, 265, 265, 265, 265, 265, 265, 265, 265, 265, 265, 266, 265, 265, 265, 265, 266, 266, 266, 266, 266, 266, 266,
266, 266, 266, 266, 266, 266, 266, 266, 266, 266, 266, 265, 265, 266, 265, 265, 266, 266, 265, 265, 265, 265, 265, 265, 265, 266, 266, 265, 265, 265, 265, 265, 265, 265, 265, 265, 265, 265, 265, 265, 265, 265, 265, 265, 265, 265, 265, 266, 266, 265, 265, 265, 265, 265, 265, 265, 265, 265, 265, 265, 266, 266, 265, 265, 266, 265, 265, 265, 265, 265, 265, 265, 265, 265, 265, 265, 265, 265, 265, 265, 265, 265, 265, 265, 265, 265, 265, 265, 266, 265, 265, 265, 265, 266, 266, 266, 266, 266, 266, 266,
266, 266, 266, 266, 266, 266, 266, 266, 266, 266, 266, 265, 265, 266, 266, 266, 266, 265, 265, 265, 265, 265, 265, 265, 265, 266, 266, 265, 265, 265, 265, 265, 265, 265, 265, 265, 265, 265, 265, 265, 265, 265, 265, 265, 265, 265, 265, 266, 266, 265, 265, 265, 265, 265, 265, 265, 265, 265, 265, 265, 266, 266, 265, 265, 266, 265, 265, 265, 265, 265, 265, 265, 265, 265, 265, 265, 265, 265, 265, 265, 265, 265, 265, 265, 265, 265, 265, 265, 266, 265, 265, 265, 265, 266, 266, 266, 266, 266, 266, 266,
266, 266, 266, 266, 266, 266, 266, 266, 266, 266, 266, 266, 265, 265, 265, 265, 265, 265, 265, 265, 265, 265, 265, 265, 265, 266, 266, 265, 265, 265, 265, 265, 265, 265, 265, 265, 265, 265, 265, 265, 265, 265, 265, 265, 265, 265, 265, 266, 266, 265, 265, 265, 265, 265, 265, 265, 265, 265, 265, 265, 266, 266, 265, 265, 266, 265, 265, 265, 265, 265, 265, 265, 265, 265, 265, 265, 265, 265, 265, 265, 265, 265, 265, 265, 265, 265, 265, 265, 266, 265, 265, 265, 265, 266, 266, 266, 266, 266, 266, 266,
266, 266, 266, 266, 266, 266, 266, 266, 266, 266, 266, 266, 265, 266, 266, 266, 266, 266, 266, 266, 266, 266, 266, 266, 266, 266, 266, 265, 265, 265, 265, 265, 265, 265, 265, 265, 265, 265, 265, 265, 265, 265, 265, 265, 265, 265, 265, 266, 266, 265, 265, 265, 266, 266, 266, 266, 266, 266, 266, 266, 266, 266, 265, 265, 266, 265, 265, 265, 265, 265, 265, 265, 265, 265, 265, 265, 265, 265, 265, 265, 265, 265, 265, 265, 265, 265, 265, 265, 266, 265, 265, 265, 265, 266, 266, 266, 266, 266, 266, 266,
265, 265, 265, 265, 265, 265, 265, 265, 265, 265, 266, 266, 265, 266, 266, 266, 266, 266, 266, 266, 266, 266, 266, 266, 266, 266, 266, 265, 265, 265, 265, 265, 265, 265, 265, 265, 265, 265, 265, 265, 265, 265, 265, 265, 265, 265, 265, 266, 266, 265, 266, 266, 266, 266, 266, 266, 266, 266, 266, 266, 266, 266, 265, 265, 266, 265, 265, 265, 265, 265, 265, 265, 265, 265, 265, 265, 265, 265, 265, 265, 265, 265, 265, 265, 265, 265, 265, 265, 266, 265, 265, 265, 265, 266, 266, 266, 266, 266, 266, 266,
265, 265, 265, 265, 265, 265, 265, 265, 265, 265, 266, 266, 265, 266, 266, 266, 266, 266, 266, 266, 266, 266, 266, 266, 266, 266, 266, 265, 265, 265, 265, 265, 265, 265, 265, 265, 265, 265, 265, 265, 265, 265, 265, 265, 265, 265, 265, 266, 266, 265, 265, 265, 265, 265, 265, 265, 265, 265, 265, 265, 265, 265, 265, 265, 266, 265, 265, 265, 265, 265, 265, 265, 265, 265, 265, 265, 265, 265, 265, 265, 265, 265, 265, 265, 265, 265, 265, 265, 266, 265, 265, 265, 265, 266, 266, 266, 266, 266, 266, 266,
265, 265, 265, 265, 265, 265, 265, 265, 265, 265, 266, 266, 265, 266, 266, 266, 266, 266, 266, 266, 266, 266, 266, 266, 266, 266, 266, 265, 265, 265, 265, 265, 265, 265, 265, 265, 265, 265, 265, 265, 265, 265, 265, 265, 265, 265, 265, 266, 266, 266, 266, 266, 266, 266, 266, 266, 266, 266, 266, 266, 266, 266, 265, 265, 266, 265, 265, 265, 265, 265, 265, 265, 265, 265, 265, 265, 265, 265, 265, 265, 265, 265, 265, 265, 265, 265, 265, 265, 266, 265, 265, 265, 265, 266, 266, 266, 266, 266, 266, 266,
265, 265, 265, 265, 265, 265, 265, 265, 265, 265, 266, 266, 265, 266, 266, 266, 266, 266, 266, 266, 266, 266, 266, 266, 266, 266, 266, 265, 265, 265, 265, 265, 265, 265, 265, 265, 265, 265, 265, 265, 265, 265, 265, 265, 265, 265, 265, 266, 266, 266, 266, 266, 266, 266, 266, 266, 266, 266, 266, 266, 266, 266, 265, 265, 266, 265, 265, 265, 265, 265, 265, 265, 265, 265, 265, 265, 265, 265, 265, 265, 265, 265, 265, 265, 265, 265, 265, 265, 266, 265, 265, 265, 265, 266, 266, 266, 266, 266, 266, 266,
265, 265, 265, 265, 265, 265, 265, 265, 265, 265, 266, 266, 265, 265, 265, 265, 265, 265, 265, 265, 265, 265, 265, 265, 265, 265, 265, 265, 265, 265, 265, 265, 265, 265, 265, 265, 265, 265, 265, 265, 265, 265, 265, 265, 265, 265, 265, 265, 265, 265, 265, 265, 265, 265, 265, 265, 265, 265, 265, 265, 266, 266, 265, 265, 266, 265, 265, 265, 265, 265, 265, 265, 265, 265, 265, 265, 265, 265, 265, 265, 265, 265, 265, 265, 265, 265, 265, 265, 266, 265, 265, 265, 265, 266, 266, 266, 266, 266, 266, 266,
265, 265, 265, 265, 265, 265, 265, 265, 265, 265, 266, 266, 265, 265, 265, 265, 265, 265, 265, 265, 265, 265, 265, 265, 265, 265, 265, 265, 265, 265, 265, 265, 265, 265, 265, 265, 265, 265, 265, 265, 265, 265, 265, 265, 265, 265, 265, 265, 265, 265, 265, 265, 265, 265, 265, 265, 265, 265, 265, 265, 266, 266, 265, 265, 266, 265, 265, 265, 265, 265, 265, 265, 265, 265, 265, 265, 265, 265, 265, 265, 265, 265, 265, 265, 265, 265, 265, 265, 266, 265, 265, 265, 265, 266, 266, 266, 266, 266, 266, 266,
265, 265, 265, 265, 265, 265, 265, 265, 265, 265, 266, 266, 265, 265, 265, 265, 265, 265, 265, 265, 265, 265, 265, 265, 265, 265, 265, 265, 265, 265, 265, 265, 265, 265, 265, 265, 265, 265, 265, 265, 265, 265, 265, 265, 265, 265, 265, 265, 265, 265, 265, 265, 265, 265, 265, 265, 265, 265, 265, 265, 266, 266, 265, 265, 266, 266, 266, 266, 266, 266, 266, 266, 266, 266, 266, 266, 266, 266, 266, 266, 266, 266, 266, 266, 265, 265, 266, 266, 266, 265, 265, 265, 265, 266, 266, 266, 266, 266, 266, 266,
266, 266, 266, 266, 266, 266, 266, 266, 266, 266, 266, 266, 266, 266, 266, 266, 266, 266, 266, 266, 266, 266, 266, 266, 266, 266, 266, 266, 266, 265, 265, 265, 265, 265, 265, 265, 265, 265, 265, 265, 265, 265, 265, 265, 265, 265, 265, 265, 265, 265, 265, 265, 265, 265, 265, 265, 265, 265, 265, 265, 265, 265, 265, 265, 265, 265, 265, 265, 265, 265, 265, 265, 265, 265, 265, 265, 265, 265, 265, 265, 265, 265, 265, 265, 265, 265, 265, 265, 265, 265, 265, 265, 265, 266, 266, 266, 266, 266, 266, 266,
265, 265, 265, 265, 265, 265, 265, 265, 265, 265, 265, 265, 265, 265, 265, 265, 265, 265, 265, 265, 265, 265, 265, 265, 265, 265, 265, 265, 266, 265, 265, 266, 266, 266, 266, 265, 265, 265, 266, 266, 266, 265, 265, 266, 266, 266, 266, 266, 266, 266, 266, 266, 266, 266, 266, 266, 266, 266, 266, 266, 266, 266, 265, 265, 265, 265, 265, 265, 265, 265, 265, 265, 265, 265, 265, 265, 265, 265, 265, 265, 265, 265, 265, 265, 265, 265, 265, 265, 265, 265, 265, 265, 265, 266, 266, 266, 266, 266, 266, 266,
265, 265, 265, 265, 265, 265, 265, 265, 265, 265, 265, 265, 265, 265, 265, 265, 265, 265, 265, 265, 265, 265, 265, 265, 265, 265, 265, 265, 266, 265, 265, 266, 265, 265, 265, 265, 265, 265, 265, 265, 266, 265, 265, 266, 266, 266, 266, 266, 266, 266, 266, 266, 266, 266, 266, 266, 266, 266, 266, 266, 266, 266, 265, 265, 265, 265, 265, 265, 265, 265, 265, 265, 265, 265, 265, 265, 265, 265, 265, 265, 265, 265, 265, 265, 265, 265, 265, 265, 265, 265, 265, 265, 265, 266, 266, 266, 266, 266, 266, 266,
265, 265, 265, 265, 265, 265, 265, 265, 265, 265, 265, 265, 265, 265, 265, 265, 265, 265, 265, 265, 265, 265, 265, 265, 265, 265, 265, 265, 266, 265, 265, 266, 265, 265, 265, 265, 265, 265, 265, 265, 266, 265, 265, 266, 266, 266, 266, 266, 266, 266, 266, 266, 266, 266, 266, 266, 266, 266, 266, 266, 266, 266, 265, 265, 265, 265, 265, 265, 265, 265, 265, 265, 265, 265, 265, 265, 265, 265, 265, 265, 265, 265, 265, 265, 265, 265, 265, 265, 265, 265, 265, 265, 265, 266, 266, 266, 266, 266, 266, 266,
265, 265, 265, 265, 265, 265, 265, 265, 265, 265, 265, 265, 265, 265, 265, 265, 265, 265, 265, 265, 265, 265, 265, 265, 265, 265, 265, 265, 266, 265, 265, 266, 265, 265, 265, 265, 265, 265, 265, 265, 266, 265, 265, 265, 265, 265, 265, 265, 265, 265, 265, 265, 265, 265, 265, 265, 265, 265, 265, 265, 265, 265, 265, 265, 265, 265, 265, 265, 265, 265, 265, 265, 265, 265, 265, 265, 265, 265, 265, 265, 265, 265, 265, 265, 265, 265, 265, 265, 265, 265, 265, 265, 265, 266, 266, 266, 266, 266, 266, 266,
265, 265, 265, 265, 265, 265, 265, 265, 265, 265, 265, 265, 265, 265, 265, 265, 265, 265, 265, 265, 265, 265, 265, 265, 265, 265, 265, 265, 266, 265, 265, 266, 265, 265, 265, 265, 265, 265, 265, 265, 266, 265, 265, 265, 265, 265, 265, 265, 265, 265, 265, 265, 265, 265, 265, 265, 265, 265, 265, 265, 266, 266, 265, 265, 266, 266, 266, 266, 266, 266, 266, 266, 266, 266, 266, 266, 266, 266, 266, 265, 265, 265, 265, 265, 265, 265, 265, 265, 265, 265, 265, 265, 265, 266, 266, 266, 266, 266, 266, 266,
265, 265, 265, 265, 265, 265, 265, 265, 265, 265, 265, 265, 265, 265, 265, 265, 265, 265, 265, 265, 265, 265, 265, 265, 265, 265, 265, 265, 266, 265, 265, 266, 265, 265, 265, 265, 265, 265, 265, 265, 266, 265, 265, 265, 265, 265, 265, 265, 265, 265, 265, 265, 265, 265, 265, 265, 265, 265, 265, 265, 266, 266, 265, 265, 266, 266, 266, 266, 266, 266, 266, 266, 266, 266, 266, 266, 266, 266, 266, 265, 265, 265, 265, 265, 265, 265, 265, 265, 265, 265, 265, 265, 265, 266, 266, 266, 266, 266, 266, 266,
265, 265, 265, 265, 265, 265, 265, 265, 265, 265, 265, 265, 265, 265, 265, 265, 265, 265, 265, 265, 265, 265, 265, 265, 265, 265, 265, 265, 266, 265, 265, 266, 265, 265, 265, 265, 265, 265, 265, 265, 266, 265, 265, 265, 265, 265, 265, 265, 265, 265, 265, 265, 265, 265, 265, 265, 265, 265, 265, 265, 266, 266, 265, 265, 266, 266, 266, 266, 266, 266, 266, 266, 266, 266, 266, 266, 266, 266, 266, 265, 265, 265, 265, 265, 265, 265, 265, 265, 265, 265, 265, 265, 265, 266, 266, 266, 266, 266, 266, 266,
265, 265, 265, 265, 265, 265, 265, 265, 265, 265, 265, 265, 265, 265, 265, 265, 265, 265, 265, 265, 265, 265, 265, 265, 265, 265, 265, 265, 266, 265, 265, 266, 265, 265, 265, 265, 265, 265, 265, 265, 266, 265, 265, 265, 265, 265, 265, 265, 265, 265, 265, 265, 265, 265, 265, 265, 265, 265, 265, 265, 266, 266, 265, 265, 266, 266, 266, 266, 266, 266, 266, 266, 266, 266, 266, 266, 266, 266, 266, 265, 265, 265, 265, 265, 265, 265, 265, 265, 265, 265, 265, 265, 265, 266, 266, 266, 266, 266, 266, 266,
265, 265, 265, 265, 265, 265, 265, 265, 265, 265, 265, 265, 265, 265, 265, 265, 265, 265, 265, 265, 265, 265, 265, 265, 265, 265, 265, 265, 266, 265, 265, 266, 265, 265, 265, 265, 265, 265, 265, 265, 266, 265, 265, 265, 265, 265, 265, 265, 265, 265, 265, 265, 265, 265, 265, 265, 265, 265, 265, 265, 266, 266, 265, 265, 266, 266, 266, 266, 266, 266, 266, 266, 266, 266, 266, 266, 266, 266, 266, 265, 265, 265, 265, 265, 265, 265, 265, 265, 265, 265, 265, 265, 265, 266, 266, 266, 266, 266, 266, 266,
265, 265, 265, 265, 265, 265, 265, 265, 265, 265, 265, 265, 265, 265, 265, 265, 265, 265, 265, 265, 265, 265, 265, 265, 265, 265, 265, 265, 266, 265, 265, 266, 265, 265, 265, 265, 265, 265, 265, 265, 266, 265, 265, 265, 265, 265, 265, 265, 265, 265, 265, 265, 265, 265, 265, 265, 265, 265, 265, 265, 266, 266, 265, 265, 265, 265, 265, 265, 265, 265, 265, 265, 265, 265, 265, 265, 265, 265, 265, 265, 265, 265, 265, 265, 265, 265, 265, 265, 265, 265, 265, 265, 265, 266, 266, 266, 266, 266, 266, 266,
265, 265, 265, 265, 265, 265, 265, 265, 265, 265, 265, 265, 265, 265, 265, 265, 265, 265, 265, 265, 265, 265, 265, 265, 265, 265, 265, 265, 266, 265, 265, 266, 265, 265, 265, 265, 265, 265, 265, 265, 266, 265, 265, 265, 265, 265, 265, 265, 265, 265, 265, 265, 265, 265, 265, 265, 265, 265, 265, 265, 266, 266, 265, 265, 265, 265, 265, 265, 265, 265, 265, 265, 265, 265, 265, 265, 265, 265, 265, 265, 265, 265, 265, 265, 265, 265, 265, 265, 265, 265, 265, 265, 265, 266, 266, 266, 266, 266, 266, 266,
265, 265, 265, 265, 265, 265, 265, 265, 265, 265, 265, 265, 265, 265, 265, 265, 265, 265, 265, 265, 265, 265, 265, 265, 265, 265, 265, 265, 266, 265, 265, 266, 265, 265, 265, 265, 265, 265, 265, 265, 266, 265, 265, 265, 265, 265, 265, 265, 265, 265, 265, 265, 265, 265, 265, 265, 265, 265, 265, 265, 266, 266, 266, 266, 266, 266, 266, 266, 266, 266, 266, 266, 266, 266, 265, 265, 265, 265, 265, 265, 265, 265, 265, 265, 265, 265, 265, 265, 265, 265, 265, 265, 265, 266, 266, 266, 266, 266, 266, 266,
265, 265, 265, 265, 265, 266, 266, 266, 266, 266, 266, 266, 266, 266, 266, 266, 266, 266, 266, 266, 266, 266, 266, 266, 266, 266, 266, 266, 266, 265, 265, 266, 265, 265, 265, 265, 265, 265, 265, 265, 266, 265, 265, 265, 265, 265, 265, 265, 265, 265, 265, 265, 265, 265, 265, 265, 265, 265, 265, 265, 266, 266, 266, 266, 266, 266, 266, 266, 266, 266, 266, 266, 266, 266, 265, 265, 265, 265, 265, 265, 265, 265, 265, 265, 265, 265, 265, 265, 265, 265, 265, 265, 265, 265, 265, 265, 265, 265, 265, 265,
265, 265, 265, 265, 265, 266, 265, 265, 265, 265, 265, 265, 265, 265, 265, 265, 265, 265, 265, 265, 265, 265, 265, 265, 265, 265, 265, 265, 265, 265, 265, 266, 265, 265, 265, 265, 265, 265, 265, 265, 266, 265, 265, 265, 265, 265, 265, 265, 265, 265, 265, 265, 265, 265, 265, 265, 265, 265, 265, 265, 266, 266, 266, 266, 266, 266, 266, 266, 266, 266, 266, 266, 266, 266, 265, 265, 265, 265, 265, 265, 265, 265, 265, 265, 265, 265, 265, 265, 265, 265, 265, 265, 265, 265, 265, 265, 265, 265, 265, 265,
265, 265, 265, 265, 265, 266, 265, 265, 265, 265, 265, 265, 265, 265, 265, 265, 265, 265, 265, 265, 265, 265, 265, 265, 265, 265, 265, 265, 265, 265, 265, 266, 265, 265, 265, 265, 265, 265, 265, 265, 266, 265, 265, 265, 265, 265, 265, 265, 265, 265, 265, 265, 265, 265, 265, 265, 265, 265, 265, 265, 265, 265, 265, 265, 265, 265, 265, 265, 265, 265, 265, 265, 265, 265, 265, 265, 265, 265, 265, 265, 265, 265, 265, 265, 265, 265, 265, 265, 265, 265, 265, 265, 265, 265, 265, 265, 265, 265, 265, 265,
265, 265, 265, 265, 265, 266, 265, 265, 265, 265, 265, 265, 265, 265, 265, 265, 265, 265, 265, 265, 265, 265, 265, 265, 265, 265, 265, 265, 265, 265, 265, 266, 265, 265, 265, 265, 265, 265, 265, 265, 266, 265, 265, 266, 266, 266, 266, 266, 266, 266, 266, 266, 266, 266, 266, 266, 266, 266, 266, 266, 266, 266, 266, 266, 266, 266, 266, 266, 266, 266, 266, 266, 266, 266, 266, 266, 266, 266, 266, 266, 266, 266, 266, 266, 266, 266, 266, 266, 266, 266, 266, 266, 266, 266, 266, 266, 266, 266, 266, 266,
265, 265, 265, 265, 265, 266, 265, 265, 265, 265, 265, 265, 265, 265, 265, 265, 265, 265, 265, 265, 265, 265, 265, 265, 265, 265, 265, 265, 265, 265, 265, 266, 265, 265, 265, 265, 265, 265, 265, 265, 266, 265, 265, 266, 266, 266, 266, 266, 266, 266, 266, 266, 266, 266, 266, 266, 266, 266, 266, 266, 266, 266, 266, 266, 266, 266, 266, 266, 266, 266, 266, 266, 266, 266, 266, 266, 266, 266, 266, 266, 266, 266, 266, 266, 266, 266, 266, 266, 266, 266, 266, 266, 266, 266, 266, 266, 266, 266, 266, 266,
265, 265, 265, 265, 265, 266, 266, 266, 266, 266, 266, 266, 266, 266, 266, 266, 266, 266, 266, 266, 266, 266, 266, 266, 266, 266, 266, 266, 266, 266, 266, 266, 265, 265, 265, 265, 265, 265, 265, 265, 266, 265, 265, 266, 266, 266, 266, 266, 266, 266, 266, 266, 266, 266, 266, 266, 266, 266, 266, 266, 266, 266, 266, 266, 266, 266, 266, 266, 266, 266, 266, 266, 266, 266, 266, 266, 266, 266, 266, 266, 266, 266, 266, 266, 266, 266, 266, 266, 266, 266, 266, 266, 266, 266, 266, 266, 266, 266, 266, 266,
265, 265, 265, 265, 265, 265, 265, 265, 265, 265, 265, 265, 265, 265, 265, 265, 265, 265, 265, 265, 265, 265, 265, 265, 265, 265, 265, 265, 265, 265, 265, 265, 265, 265, 265, 265, 265, 265, 265, 265, 266, 265, 265, 266, 266, 266, 266, 266, 266, 266, 266, 266, 266, 266, 266, 266, 266, 266, 266, 266, 266, 266, 266, 266, 266, 266, 266, 266, 266, 266, 266, 266, 266, 266, 266, 266, 266, 266, 266, 266, 266, 266, 266, 266, 266, 266, 266, 266, 266, 266, 266, 266, 266, 266, 266, 266, 266, 266, 266, 266,
265, 265, 265, 265, 265, 265, 265, 265, 265, 265, 265, 265, 265, 265, 265, 265, 265, 265, 265, 265, 265, 265, 265, 265, 265, 265, 265, 265, 265, 265, 265, 265, 265, 265, 265, 265, 265, 265, 265, 265, 266, 265, 265, 266, 266, 266, 266, 266, 266, 266, 266, 266, 266, 266, 266, 266, 266, 266, 266, 266, 266, 266, 266, 266, 266, 266, 266, 266, 266, 266, 266, 266, 266, 266, 266, 266, 266, 266, 266, 266, 266, 266, 266, 266, 266, 266, 266, 266, 266, 266, 266, 266, 266, 266, 266, 266, 266, 266, 266, 266,
265, 265, 265, 265, 265, 265, 265, 265, 265, 265, 265, 265, 265, 265, 265, 265, 265, 265, 265, 265, 265, 265, 265, 265, 265, 265, 265, 265, 265, 265, 265, 265, 265, 265, 265, 265, 265, 265, 265, 265, 266, 265, 265, 266, 266, 266, 266, 266, 266, 266, 266, 266, 266, 266, 266, 266, 266, 266, 266, 266, 266, 266, 266, 266, 266, 266, 266, 266, 266, 266, 266, 266, 266, 266, 266, 266, 266, 266, 266, 266, 266, 266, 266, 266, 266, 266, 266, 266, 266, 266, 266, 266, 266, 266, 266, 266, 266, 266, 266, 266,
265, 265, 265, 265, 265, 265, 265, 265, 265, 265, 265, 265, 265, 265, 265, 265, 265, 265, 265, 265, 265, 265, 265, 265, 265, 265, 265, 265, 265, 265, 265, 265, 265, 265, 265, 265, 265, 265, 265, 265, 266, 265, 265, 266, 266, 266, 266, 266, 266, 266, 266, 266, 266, 266, 266, 266, 266, 266, 266, 266, 266, 266, 266, 266, 266, 266, 266, 266, 266, 266, 266, 266, 266, 266, 266, 266, 266, 266, 266, 266, 266, 266, 266, 266, 266, 266, 266, 266, 266, 266, 266, 266, 266, 266, 266, 266, 266, 266, 266, 266,
265, 265, 265, 265, 265, 265, 265, 265, 265, 265, 265, 265, 265, 265, 265, 265, 265, 265, 265, 265, 265, 265, 265, 265, 265, 265, 265, 265, 265, 265, 265, 265, 265, 265, 265, 265, 265, 265, 265, 265, 266, 265, 265, 266, 266, 266, 266, 266, 266, 266, 266, 266, 266, 266, 266, 266, 266, 266, 266, 266, 266, 266, 266, 266, 266, 266, 266, 266, 266, 266, 266, 266, 266, 266, 266, 266, 266, 266, 266, 266, 266, 266, 266, 266, 266, 266, 266, 266, 266, 266, 266, 266, 266, 266, 266, 266, 266, 266, 266, 266,
265, 265, 265, 265, 265, 265, 265, 265, 265, 265, 265, 265, 265, 265, 265, 265, 265, 265, 265, 265, 265, 265, 265, 265, 265, 265, 265, 265, 265, 265, 265, 265, 265, 265, 265, 265, 265, 265, 265, 265, 266, 265, 265, 266, 266, 266, 266, 266, 266, 266, 266, 266, 266, 266, 266, 266, 266, 266, 266, 266, 266, 266, 266, 266, 266, 266, 266, 266, 266, 266, 266, 266, 266, 266, 266, 266, 266, 266, 266, 266, 266, 266, 266, 266, 266, 266, 266, 266, 266, 266, 266, 266, 266, 266, 266, 266, 266, 266, 266, 266,
265, 265, 265, 265, 265, 265, 265, 265, 265, 265, 265, 265, 265, 265, 265, 265, 265, 265, 265, 265, 265, 265, 265, 265, 265, 265, 265, 265, 265, 265, 265, 265, 265, 265, 265, 265, 265, 265, 265, 265, 266, 265, 265, 266, 266, 266, 266, 266, 266, 266, 266, 266, 266, 266, 266, 266, 266, 266, 266, 266, 266, 266, 266, 266, 266, 266, 266, 266, 266, 266, 266, 266, 266, 266, 266, 266, 266, 266, 266, 266, 266, 266, 266, 266, 266, 266, 266, 266, 266, 266, 266, 266, 266, 266, 266, 266, 266, 266, 266, 266