159, 112, 113, 113, 113, 113, 113, 113, 113, 113, 113, 113, 113, 113, 113, 114,
159, 134, 47, 47, 47, 47, 47, 47, 47, 47, 47, 47, 47, 47, 47, 137,
159, 134, 47, 69, 69, 69, 69, 69, 69, 69, 47, 47, 47, 47, 47, 29,
113, 138, 47, 47, 47, 47, 47, 47, 47, 47, 47, 69, 47, 47, 47, 50,
69, 69, 47, 115, 157, 157, 157, 157, 116, 47, 47, 47, 69, 69, 69, 72,
25, 28, 47, 136, 159, 112, 113, 113, 138, 47, 47, 69, 69, 47, 54, 72,
47, 72, 47, 137, 113, 138, 47, 47, 47, 33, 69, 69, 69, 69, 69, 72,
91, 94, 55, 47, 54, 47, 47, 47, 47, 47, 47, 47, 47, 47, 69, 72,
91, 91, 91, 91, 30, 69, 69, 99, 31, 69, 69, 69, 69, 69, 47, 72,
47, 69, 69, 69, 68, 69, 69, 69, 69, 69, 69, 69, 70, 69, 71, 72,
47, 69, 54, 55, 90, 91, 91, 91, 91, 91, 91, 91, 92, 69, 93, 94,
47, 47, 47, 47, 47, 47, 47, 47, 47, 47, 47, 47, 69, 32, 33, 47