47, 68, 47, 47, 47, 47, 47, 47, 47, 47, 47, 47, 47, 47, 47, 50,
47, 68, 47, 47, 47, 47, 47, 47, 47, 47, 47, 47, 47, 47, 47, 72,
47, 68, 47, 69, 69, 69, 69, 69, 69, 69, 47, 47, 47, 47, 47, 50,
47, 68, 47, 47, 47, 47, 47, 47, 47, 47, 47, 69, 47, 47, 47, 72,
47, 68, 47, 115, 157, 157, 157, 157, 116, 47, 47, 47, 69, 69, 69, 72,
47, 68, 47, 136, 159, 112, 113, 113, 138, 47, 47, 69, 69, 47, 69, 72,
47, 68, 47, 137, 113, 138, 47, 47, 47, 47, 69, 69, 69, 69, 69, 72,
47, 68, 47, 47, 47, 47, 47, 47, 47, 47, 47, 47, 47, 47, 69, 72,
47, 46, 47, 69, 69, 69, 69, 69, 69, 69, 69, 69, 69, 69, 47, 72,
47, 68, 47, 69, 69, 69, 69, 69, 69, 69, 69, 69, 69, 69, 69, 72,
47, 90, 91, 91, 91, 91, 91, 91, 91, 91, 91, 91, 92, 70, 93, 94,
47, 47, 47, 47, 47, 47, 47, 47, 47, 47, 47, 47, 47, 47, 47, 47