46, 67, 46, 46, 46, 46, 46, 46, 46, 46, 46, 46, 46, 46, 46, 49,
46, 67, 46, 46, 46, 46, 46, 46, 46, 46, 46, 46, 46, 46, 46, 71,
46, 67, 46, 68, 68, 68, 68, 68, 68, 68, 46, 46, 46, 46, 46, 49,
46, 67, 46, 46, 46, 46, 46, 46, 46, 46, 46, 68, 46, 46, 46, 71,
46, 67, 46, 114, 156, 156, 156, 156, 115, 46, 46, 46, 68, 68, 68, 71,
46, 67, 46, 135, 158, 111, 112, 112, 137, 46, 46, 68, 68, 46, 68, 71,
46, 67, 46, 136, 112, 137, 46, 46, 46, 46, 68, 68, 68, 68, 68, 71,
46, 67, 46, 46, 46, 46, 46, 46, 46, 46, 46, 46, 46, 46, 68, 71,
46, 45, 46, 68, 68, 68, 68, 68, 68, 68, 68, 68, 68, 68, 46, 71,
46, 67, 46, 68, 68, 68, 68, 68, 68, 68, 68, 68, 68, 68, 68, 71,
46, 89, 90, 90, 90, 90, 90, 90, 90, 90, 90, 90, 91, 69, 92, 93,
46, 46, 46, 46, 46, 46, 46, 46, 46, 46, 46, 46, 46, 46, 46, 46